     AAAAAAAAAAAAAAAAAAAAAAAAAAA
       BBBA                     
       AAAA                     
AABB      A     b               
         BA    AAA           b  
A         A                 AAA 
AAB   AAAAA                     
BBBA  BB BA      b b            
BBB B     A    CCCCCCC          
A         A                     
BBBBBBB  AA                     
          A                     
B       AAA                b    
B        AA              CCCCC  
A        AA                     
BB       BA                     
BB   BAAAAAAAAAAAAAABAABABAAAABB
A         AAAAAAB BAAAB BAAAB BA
BBB     AAAAAAAAAbAAAAAbAAABAbAA
AAAAAAANAAAAAAAAAAAAAAAAAAAAAAAA