*
*
     AAAAAAAAAAAAAAAA  AAAAA
     BBBBBBBBBBBBBAAA  BBBBB
*
*
B            b              
BBBBBBBBBBBBBBBBB AAA  BBBBB
*
B                           
AAAAAAAAAA  AAAAAAAAA BBBBBB
BBBBBBBBBB        AAABBBBBBB
AAAAAAAAAA        AAA  BBBBB
BBBBBBBBBBBBBBBBB AAA  BBBBB
*
*
            b               
AAAAAAAAAAAAAAAA A          
*
*
AAA  AAAAAAAAAAAAAAAAAAAAAAA
AAA  BBBBBBBBBBBBBBBBBBBBBBB
*
*
B            b              
BBBBBBBBBBBBBBBBB BBBBBBBBBB
*
B                           
AAAAAAAAAA  AAAAAA AAAAAAAAA
BBBBBBBBBB                  
AAAAAAAAAAAAA       AAAAAAAA
BBBBBBBBBBBBBBBBB   AAAAAAAA
*
*
            b               
AAAAAAAAAAAAAAAANAAAAAAAAAAA