*
*
*
*
*
AAAAAAAAAAAAA   AAAAAAAAAAAA
*
*
AAAAAAAAAAAAAAAAAAAAA    AAA
*
*
                 BAAABABBBAA
               AAAABAACCCCAA
             BBBAAABBAC bCAA
           BBBAAABAAABC  CAA
         BBAAABAAABAAACCCCBA
       BAAABAAABAAABAAABAAAB
     AAAAAAAAAAAAAAAAAAAAAAA
          BB                
          BB    b           
AAAA      BB                
          BB   AAA     b    
      AAAABB                
          BB     b    AAA   
AAAA      BB                
          BB    AAA         
          BB           b    
       AAABB                
          BB    b     AAA   
AAAA     ABB                
         ABB   AAA          
A        ABB                
BB       BBB                
BB   BAAABBBAAAAAAAABAABABAA
A        BBBAAAA b BAAB b AA
BBB     ABBBAAAA   AAAA   AB
AAAAAA  AAAAAAAAAAAAAAAAAAAA
*
*
                        A   
*
*
A                           
*
*
      A	                    
*
*
*
*
*
            A               
*
*
   A               A        
*
       A        A          A
 A           A          A   
AAAA    A            A    A 
AAAAAAAAAAAAAA@@@AAAAAAAAAAA